..##.....T
ET##..###.
#.###E###E
#SE...###.
E.#T#####G