..##.....T
#T##..###.
#.###E###E
#SE...###.
###T#####G